wwwwwwwwwwwwwwwwwwww
wWWWWWWWWWWWWWWWWWWw
wWWWWWWWWWGGGGGWWWWw
wWWWWGGGGGGGGGGGGGWw
wWGGGGGGGGGGGGGGGWWw
wGGGGGGGGGGGGGGWWWWw
wGGGGGGGGGGGGGGGWWWw
wGGGGGGGGGGGGGWWWWWw
wGGGGGGGGGGGWWWWWWWw
wGGGGGGGGGGGGWWWWWWw
wGGGGGGGGGGGGGGWWWWw
wGGGGGGGGGGGGGGGWWWw
wWGGGGGGGGGGGGGGGWWw
wWWGGGGGGGGGGGGWWWWw
wWWWWGGGGGGGGGGGWWWw
wWWWWWWGGGGGGGGWWWWw
wWWWWWWWWGGGGGWWWWWw
wWWWWWWWWWWGWWWWWWWw
wWWWWWWWWWWWWWWWWWWw
wwwwwwwwwwwwwwwwwwww